kielbasa	/kiɫˈbɑsə/
kigali	/kiˈɡɑɫi/
kigali's	/kiˈɡɑɫiz/

chemo	/ˈkimoʊ/
kea	/ˈki/
keach	/ˈkitʃ/
keagan	/ˈkiɡən/
keeling	/ˈkiɫɪŋ/
keels	/ˈkiɫz/
keen	/ˈkin/
keenan	/ˈkinən/
keener	/ˈkinɝ/
keenest	/ˈkinəst/
keep	/ˈkip/
keeper	/ˈkipɝ/
keepers	/ˈkipɝz/
keeping	/ˈkipɪŋ/
keeps	/ˈkips/
keepsake	/ˈkipˌseɪk/
keepsakes	/ˈkipˌseɪks/
keister	/ˈkiɪstɝ/
keith	/ˈkiθ/
keith's	/ˈkiθs/
ketone	/ˈkitoʊn/
key	/ˈki/
key's	/ˈkiz/
keyboard	/ˈkiˌbɔɹd/
keyboarding	/ˈkiˌbɔɹdɪŋ/
keyboards	/ˈkiˌbɔɹdz/
keyed	/ˈkid/
keyhole	/ˈkiˌhoʊɫ/
keyholes	/ˈkiˌhoʊɫz/
keying	/ˈkiɪŋ/
keyless	/ˈkiɫəs/
keynote	/ˈkiˌnoʊt/
keynotes	/ˈkiˌnoʊts/
keypad	/ˈkiˌpæd/
keypad's	/ˈkiˌpædz/
keypads	/ˈkiˌpædz/
keys	/ˈkiz/
keystone	/ˈkiˌstoʊn/
keystone's	/ˈkiˌstoʊnz/
keystones	/ˈkiˌstoʊnz/
keystroke	/ˈkiˌstɹoʊk/
keystrokes	/ˈkiˌstɹoʊks/
keyword	/ˈkiˌwɝd/
keywords	/ˈkiˌwɝdz/
kia	/ˈkiɝ/
kiki	/ˈkiki/
kikkoman	/ˈkikoʊmɑn/
kilos	/ˈkiˌɫoʊz/
kiosk	/ˈkiˌɔsk/
kiosks	/ˈkiˌɔsks/
kiwi	/ˈkiwi/
kiwi's	/ˈkiwiz/
kiwis	/ˈkiwiz/
<!-- qi	/ˈki/ -->

chemotherapy	/ˌkimoʊˈθɛɹəpi/
key-largo	/ˌkiˈɫɑɹɡoʊ/
key-west	/ˌkiˈwɛst/
kiev	/ˌkiˈɛv/
kiev's	/ˌkiˈɛvz/
kilauea	/ˌkiˌɫaʊˈeɪə/
quinoa	/ˌkiˈnoʊə/
