couture	/kuˈtʊɹ/
couturier	/kuˈtʊɹiɝ/
kuwait	/kuˈweɪt/
kuwait's	/kuˈweɪts/
kuwaiti	/kuˈweɪti/
kuwaitis	/kuˈweɪtiz/

coochie	/ˈkutʃi/
cool	/ˈkuɫ/
coolant	/ˈkuɫənt/
coolants	/ˈkuɫənts/
cooled	/ˈkuɫd/
cooler	/ˈkuɫɝ/
coolers	/ˈkuɫɝz/
coolest	/ˈkuɫəst/
coolidge	/ˈkuɫɪdʒ/
coolidge's	/ˈkuɫɪdʒəz/
cooling	/ˈkuɫɪŋ/
coolio	/ˈkuˌɫioʊ/, /ˈkuɫjoʊ/
coolly	/ˈkuɫi/
coolness	/ˈkuɫnəs/
cools	/ˈkuɫz/
coomer	/ˈkumɝ/
coon	/ˈkun/
coop	/ˈkup/
cooped	/ˈkupt/
cooper	/ˈkupɝ/
cooper's	/ˈkupɝz/
cooperage	/ˈkupɝədʒ/
coopers	/ˈkupɝz/
<!-- coors	/ˈkuɹz/ -->
coot	/ˈkut/
coots	/ˈkuts/
cougar	/ˈkuɡɝ/
cougars	/ˈkuɡɝz/
coulee	/ˈkuɫi/
coup	/ˈku/
coupe	/ˈkup/
coupes	/ˈkups/
coups	/ˈku/, /ˈkuz/
cuckoo's	/ˈkukuz/
cuckoos	/ˈkukuz/

couchette	/ˌkuˈʃɛt/
couchettes	/ˌkuˈʃɛts/
cousteau	/ˌkuˈstoʊ/
cousteau's	/ˌkuˈstoʊz/
cupertino	/ˌkupɝˈtinoʊ/
