ghoul	/ˈɡuɫ/
ghoulish	/ˈɡuɫɪʃ/
ghoulishly	/ˈɡuɫɪʃɫi/
ghouls	/ˈɡuɫz/
goo	/ˈɡu/
gooch	/ˈɡutʃ/
gooey	/ˈɡui/
goof	/ˈɡuf/
goofed	/ˈɡuft/
goofing	/ˈɡufɪŋ/
goofs	/ˈɡufs/
goofy	/ˈɡufi/
google	/ˈɡuɡəɫ/
google's	/ˈɡuɡəɫz/
googled	/ˈɡuɡəɫd/
googles	/ˈɡuɡəɫz/
googleverse	/ˈɡuɡəɫˌvɝs/
googling	/ˈɡuɡɫɪŋ/
goon	/ˈɡun/
goons	/ˈɡunz/
goop	/ˈɡup/
goose	/ˈɡus/
goose's	/ˈɡusɪz/
gooseberries	/ˈɡusˌbɛɹiz/
gooseberry	/ˈɡusˌbɛɹi/
goosefish	/ˈɡusˌfɪʃ/
goosefoot	/ˈɡusˌfʊt/
goosey	/ˈɡusi/
goulash	/ˈɡuˌɫɑʃ/
gu	/ˈɡu/
gucci	/ˈɡutʃi/
guggenheim	/ˈɡuɡənˌhaɪm/
guggenheim's	/ˈɡuɡənˌhaɪmz/
guru	/ˈɡuˌɹu/
guru's	/ˈɡuˌɹuz/
gurus	/ˈɡuˌɹuz/
gutenberg	/ˈɡutənbɝɡ/
