co-leader	/koʊˈɫidɝ/
co-leaders	/koʊˈɫidɝz/
co-opt	/koʊˈɑpt/
co-opted	/koʊˈɑptəd/
coagulate	/koʊˈæɡjəˌɫeɪt/
coagulating	/koʊˈæɡjəˌɫeɪtɪŋ/
coagulation	/koʊˈæɡjəˈɫeɪʃən/
cocaine	/koʊˈkeɪn/
coenzyme	/koʊˈɛnzaɪm/
coequal	/koʊˈikwəɫ/
coerce	/koʊˈɝs/
coerced	/koʊˈɝst/
coercing	/koʊˈɝsɪŋ/
coercion	/koʊˈɝʃən/
coercive	/koʊˈɝsɪv/
cohabit	/koʊˈhæbɪt/
cohabitation	/koʊˌhæbəˈteɪʃən/
cohabiting	/koʊˈhæbɪtɪŋ/
cohere	/koʊˈhɪɹ/
cohered	/koʊˈhɪɹd/
coherence	/koʊˈhɪɹəns/
coherent	/koʊˈhɪɹənt/
coherently	/koʊˈhiɹəntɫi/
coheres	/koʊˈhɪɹz/
cohesion	/koʊˈhiʒən/
cohesive	/koʊˈhisɪv/
cohesively	/koʊˈhisɪvɫi/
cohesiveness	/koʊˈhisɪvnəs/
coincidence	/koʊˈɪnsɪdəns/
coincidences	/koʊˈɪnsədənsɪz/
coincident	/koʊˈɪnsədənt/
coincidental	/koʊˌɪnsəˈdɛntəɫ/
coincidentally	/koʊˌɪnsɪˈdɛnəɫi/, /koʊˌɪnsɪˈdɛntəɫi/
cooperates	/koʊˈɑpɝˌeɪts/
cooperating	/koʊˈɑpɝˌeɪtɪŋ/
cooperative	/koʊˈɑpɝˌeɪtɪv/
cooperatively	/koʊˈɑpɹətɪvɫi/
cooperatives	/koʊˈɑpɹətɪvz/
coordinate	/koʊˈɔɹdəˌneɪt/, /koʊˈɔɹdənət/
coordinated	/koʊˈɔɹdəneɪtɪd/
coordinates	/koʊˈɔɹdəˌneɪts/, /koʊˈɔɹdənəts/
coordinating	/koʊˈɔɹdəˌneɪtɪŋ/
coordination	/koʊˌɔɹdəˈneɪʃən/
coordinator	/koʊˈɔɹdəˌneɪtɝ/
coordinators	/koʊˈɔɹdəˌneɪtɝz/
covalent	/koʊˈvɑɫənt/
koala	/koʊˈɑɫə/
koalas	/koʊˈɑɫəz/

co-founder	/ˈkoʊˈfaʊndɝ/
co-op	/ˈkoʊˌɑp/
co-owner	/ˈkoʊˌoʊnɝ/
co-wife	/ˈkoʊˈwaɪf/
co-worker	/ˈkoʊˈwɝkɝ/
co-workers	/ˈkoʊˈwɝkɝz/
coach	/ˈkoʊtʃ/
coach's	/ˈkoʊtʃɪz/
coached	/ˈkoʊtʃt/
coaches	/ˈkoʊtʃɪz/
coaching	/ˈkoʊtʃɪŋ/
coachman	/ˈkoʊtʃmən/
coal	/ˈkoʊɫ/
coal's	/ˈkoʊɫz/
coals	/ˈkoʊɫz/
coast	/ˈkoʊst/
coast's	/ˈkoʊsts/
coastal	/ˈkoʊstəɫ/
coastal's	/ˈkoʊstəɫz/
coasted	/ˈkoʊstɪd/
coaster	/ˈkoʊstɝ/
coasters	/ˈkoʊstɝz/
coasting	/ˈkoʊstɪŋ/
coastline	/ˈkoʊstˌɫaɪn/
coastlines	/ˈkoʊstˌɫaɪnz/
coasts	/ˈkoʊsts/
coat	/ˈkoʊt/
coat's	/ˈkoʊts/
coated	/ˈkoʊtəd/, /ˈkoʊtɪd/
coates	/ˈkoʊˈeɪts/
coating	/ˈkoʊtɪŋ/
coatings	/ˈkoʊtɪŋz/
coats	/ˈkoʊts/
coattail	/ˈkoʊtˌteɪɫ/
coattails	/ˈkoʊtˌteɪɫz/
coauthor	/ˈkoʊˈɑθɝ/
coauthored	/ˈkoʊˈɑθɝd/
coauthoring	/ˈkoʊˈɑθɝɪŋ/
coauthors	/ˈkoʊˈɑθɝz/
coax	/ˈkoʊks/
coaxed	/ˈkoʊkst/
coaxes	/ˈkoʊksɪz/
coaxial	/ˈkoʊˈæksiəɫ/
coaxing	/ˈkoʊksɪŋ/
cobain	/ˈkoʊˌbeɪn/
cobain's	/ˈkoʊˌbeɪnz/
cobalt	/ˈkoʊˌbɔɫt/
coca	/ˈkoʊkə/
coco	/ˈkoʊˌkoʊ/
cocoa	/ˈkoʊkoʊ/
cocoanuts	/ˈkoʊkoʊˌnəts/
coconut	/ˈkoʊkəˌnət/
coconuts	/ˈkoʊkəˌnəts/
cocos	/ˈkoʊˌkoʊz/
coda	/ˈkoʊdə/
code	/ˈkoʊd/
code's	/ˈkoʊdz/
codebase	/ˈkoʊdˌbeɪs/
codebreaker	/ˈkoʊdˌbɹeɪkɝ/
codebreakers	/ˈkoʊdˌbɹeɪkɝz/
coded	/ˈkoʊdɪd/
coder	/ˈkoʊdɝ/
codes	/ˈkoʊdz/
codifies	/ˈkoʊdəˌfaɪz/
<!-- codify	/ˈkoʊdəˌfaɪ/ -->
<!-- codifying	/ˈkoʊdəˌfaɪɪŋ/ -->
coding	/ˈkoʊdɪŋ/
cody	/ˈkoʊdi/
coed	/ˈkoʊˌɛd/, /ˈkoʊd/
coeds	/ˈkoʊˌɛdz/
coeducational	/ˈkoʊˈɛdʒəˈkeɪʃənəɫ/
cohan	/ˈkoʊhən/
cohen	/ˈkoʊən/
cohen's	/ˈkoʊənz/
cohort	/ˈkoʊhɔɹt/
cohorts	/ˈkoʊhɔɹts/
cohost	/ˈkoʊˌhoʊst/
cohosts	/ˈkoʊˌhoʊsts/
coke	/ˈkoʊk/
coke's	/ˈkoʊks/
cokes	/ˈkoʊks/
cola	/ˈkoʊɫə/
cola's	/ˈkoʊɫəz/
colab	/ˈkoʊˈɫæb/
colaw	/ˈkoʊˈɫɔ/
colbert	/ˈkoʊɫbɝt/
cold	/ˈkoʊɫd/
cold-bay	/ˈkoʊɫdˌbeɪ/
cold-blood	/ˈkoʊɫdˈbɫəd/
cold-blooded	/ˈkoʊɫdˈbɫədəd/
colder	/ˈkoʊɫdɝ/
coldest	/ˈkoʊɫdəst/
coldly	/ˈkoʊɫdɫi/
coldness	/ˈkoʊɫdnəs/
colds	/ˈkoʊɫdz/
cole	/ˈkoʊɫ/
cole's	/ˈkoʊɫz/
coleman	/ˈkoʊɫmən/
coleman's	/ˈkoʊɫmənz/
coleslaw	/ˈkoʊɫˌsɫɑ/
colette	/ˈkoʊˈɫɛt/
colgate	/ˈkoʊɫɡeɪt/
colgate's	/ˈkoʊɫɡeɪts/
colt	/ˈkoʊɫt/
colt's	/ˈkoʊɫts/
colts	/ˈkoʊɫts/
coma	/ˈkoʊmə/
comas	/ˈkoʊməz/
comatose	/ˈkoʊməˌtoʊs/
comb	/ˈkoʊm/
combe	/ˈkoʊm/
combed	/ˈkoʊmd/
comber	/ˈkoʊmɝ/
combes	/ˈkoʊmz/
combing	/ˈkoʊmɪŋ/
combs	/ˈkoʊmz/
conan	/ˈkoʊnən/
cone	/ˈkoʊn/
cone's	/ˈkoʊnz/
coneflower	/ˈkoʊnˌfɫaʊɝ/
cones	/ˈkoʊnz/
conus	/ˈkoʊnəs/
copayment	/ˈkoʊˈpeɪmənt/
copayments	/ˈkoʊˈpeɪmənts/
cope	/ˈkoʊp/
coped	/ˈkoʊpt/
copenhagen	/ˈkoʊpənˌhɑɡən/, /ˈkoʊpənˌheɪɡən/
copenhagen's	/ˈkoʊpənˌhɑɡənz/, /ˈkoʊpənˌheɪɡənz/
copes	/ˈkoʊps/
copilot	/ˈkoʊpaɪɫət/
copilots	/ˈkoʊpaɪɫəts/
coping	/ˈkoʊpɪŋ/
copious	/ˈkoʊpiəs/
copiously	/ˈkoʊpjəsɫi/
coprocessor	/ˈkoʊˈpɹɑsɛsɝ/
coprocessors	/ˈkoʊˈpɹɑsɛsɝz/
costar	/ˈkoʊstɑɹ/
costars	/ˈkoʊstɑɹz/
covert	/ˈkoʊvɝt/
coves	/ˈkoʊvz/
coworker	/ˈkoʊˈwɝkɝ/
coworkers	/ˈkoʊˈwɝkɝz/
cozier	/ˈkoʊziɝ/
coziness	/ˈkoʊzinəs/
cozy	/ˈkoʊzi/
cozying	/ˈkoʊziɪŋ/
kobe	/ˈkoʊbeɪ/
kobe's	/ˈkoʊbeɪz/
kodak	/ˈkoʊˌdæk/
kodak's	/ˈkoʊˌdæks/
kohl	/ˈkoʊɫ/
kohl's	/ˈkoʊɫz/
kokomo	/ˈkoʊkəˌmoʊ/
kosher	/ˈkoʊʃɝ/

co-operative	/ˌkoʊˈɑˌpɝətɪv/, /ˌkoʊˈɑpɹətɪv/
coalesce	/ˌkoʊəˈɫɛs/
coalesced	/ˌkoʊəˈɫɛst/
coalescence	/ˌkoʊəˈɫɛsəns/
coalesces	/ˌkoʊəˈɫɛsɪz/
coalescing	/ˌkoʊəˈɫɛsɪŋ/
coalition	/ˌkoʊəˈɫɪʃən/
coalition's	/ˌkoʊəˈɫɪʃənz/
coalitions	/ˌkoʊəˈɫɪʃənz/
coca-cola	/ˌkoʊkəˈkoʊɫɑ/
coefficient	/ˌkoʊəˈfɪʃənt/
coefficients	/ˌkoʊəˈfɪʃənts/
coexist	/ˌkoʊəɡˈzɪst/
coexisted	/ˌkoʊəɡˈzɪstəd/
coexistence	/ˌkoʊɪɡˈzɪstəns/
coexisting	/ˌkoʊɪɡˈzɪstɪŋ/
coincide	/ˌkoʊɪnˈsaɪd/
coincided	/ˌkoʊənˈsaɪdəd/
coincides	/ˌkoʊɪnˈsaɪdz/
coinciding	/ˌkoʊənˈsaɪdɪŋ/
coinsurance	/ˌkoʊɪnˈʃɝəns/
cosponsor	/ˌkoʊˈspɔnsɝ/
cosponsors	/ˌkoʊˈspɔnsɝz/
