Jocko

<!-- george	/ˈdʒɔɹdʒ/ -->
<!-- george's	/ˈdʒɔɹdʒəz/, /ˈdʒɔɹdʒɪz/ -->
<!-- georgetown	/ˈdʒɔɹdʒˌtaʊn/ -->
<!-- georgia	/ˈdʒɔɹdʒə/ -->
<!-- georgia's	/ˈdʒɔɹdʒəz/ -->
<!-- georgian	/ˈdʒɔɹdʒən/ -->
<!-- georgians	/ˈdʒɔɹdʒənz/ -->
jaundice	/ˈdʒɔndəs/
jaundiced	/ˈdʒɔndɪst/
jaunt	/ˈdʒɔnt/
jauntily	/ˈdʒɔntəɫi/
jaunts	/ˈdʒɔnts/
jaunty	/ˈdʒɔnti/
jaw	/ˈdʒɔ/
jawbone	/ˈdʒɔˌboʊn/
jawboning	/ˈdʒɔˌboʊnɪŋ/
jawed	/ˈdʒɔd/
jaws	/ˈdʒɔz/
jocelin	/ˈdʒɔˌsɫɪn/
joceline	/ˈdʒɔˌsɫɪn/
jocelyn	/ˈdʒɔˌsɫɪn/
jocelyne	/ˈdʒɔˌsɫɪn/
jocylan	/ˈdʒɔsɫən/
jocylan's	/ˈdʒɔsɫənz/
joffrey	/ˈdʒɔfɹi/
<!-- joice	/ˈdʒɔɪs/ -->
<!-- join	/ˈdʒɔɪn/ -->
<!-- joined	/ˈdʒɔɪnd/ -->
<!-- joiner	/ˈdʒɔɪnɝ/ -->
<!-- joinery	/ˈdʒɔɪnɝi/ -->
<!-- joines	/ˈdʒɔɪnz/ -->
<!-- joining	/ˈdʒɔɪnɪŋ/ -->
<!-- joins	/ˈdʒɔɪnz/ -->
<!-- joint	/ˈdʒɔɪnt/ -->
<!-- jointed	/ˈdʒɔɪnɪd/, /ˈdʒɔɪntəd/, /ˈdʒɔɪntɪd/ -->
<!-- jointly	/ˈdʒɔɪntɫi/ -->
<!-- jointness	/ˈdʒɔɪntnəs/ -->
<!-- joints	/ˈdʒɔɪnts/ -->
<!-- joist	/ˈdʒɔɪst/ -->
<!-- joists	/ˈdʒɔɪsts/ -->
jong	/ˈdʒɔŋ/
<!-- jordan	/ˈdʒɔɹdən/ -->
<!-- jordan's	/ˈdʒɔɹdənz/ -->
<!-- jordans	/ˈdʒɔɹdənz/ -->
<!-- jorgensen	/ˈdʒɔɹɡɪnsən/ -->
<!-- jorgenson	/ˈdʒɔɹɡɪnsən/ -->
joss	/ˈdʒɔs/
<!-- joy	/ˈdʒɔɪ/ -->
<!-- joy-thrill	/ˈdʒɔɪˌθɹɪɫ/ -->
<!-- joy's	/ˈdʒɔɪz/ -->
<!-- joyful	/ˈdʒɔɪfəɫ/ -->
<!-- joyfully	/ˈdʒɔɪfəɫi/ -->
<!-- joying	/ˈdʒɔɪɪŋ/ -->
<!-- joyride	/ˈdʒɔɪˌɹaɪd/ -->
<!-- joyriding	/ˈdʒɔɪˌɹaɪdɪŋ/ -->
<!-- joys	/ˈdʒɔɪz/ -->
<!-- joystick	/ˈdʒɔɪˌstɪk/ -->

jar	/ˈdʒɑɹ/
jargon	/ˈdʒɑɹɡən/
jarred	/ˈdʒɑɹd/
jarring	/ˈdʒɑɹɪŋ/
jars	/ˈdʒɑɹz/
jarvis	/ˈdʒɑɹvəs/, /ˈdʒɑɹvɪs/
jarvis's	/ˈdʒɑɹvɪsɪz/
java	/ˈdʒɑvə/
javascript	/ˈdʒɑvəsˌkɹɪpt/
job	/ˈdʒɑb/, /ˈdʒoʊb/
job's	/ˈdʒɑbz/, /ˈdʒoʊbz/
jobber	/ˈdʒɑbɝ/
jobbers	/ˈdʒɑbɝz/
jobless	/ˈdʒɑbɫəs/
joblessness	/ˈdʒɑbɫəsnəs/
jobs	/ˈdʒɑbz/
jobs'	/ˈdʒɑbz/
jobs's	/ˈdʒɑbzɪz/
jock	/ˈdʒɑk/
jockey	/ˈdʒɑki/
jockeying	/ˈdʒɑkiɪŋ/
jockeys	/ˈdʒɑkiz/
jocks	/ˈdʒɑks/
jocular	/ˈdʒɑkjəɫɝ/
jog	/ˈdʒɑɡ/
jogged	/ˈdʒɑɡd/
jogger	/ˈdʒɑɡɝ/
joggers	/ˈdʒɑɡɝz/
jogging	/ˈdʒɑɡɪŋ/, /ˈdʒɔɡɪŋ/
jogs	/ˈdʒɑɡz/
john	/ˈdʒɑn/
john's	/ˈdʒɑnz/
johnathan	/ˈdʒɑnəθən/
johnathan's	/ˈdʒɑnəθənz/
johnathon	/ˈdʒɑnəθən/
johnathon's	/ˈdʒɑnəθənz/
johnie	/ˈdʒɑni/
johnnie	/ˈdʒɑni/
johnnie's	/ˈdʒɑniz/
johnny	/ˈdʒɑni/
johnny's	/ˈdʒɑniz/
johns	/ˈdʒɑnz/
johns's	/ˈdʒɑnzɪz/
johnsen	/ˈdʒɑnsən/
johnsen's	/ˈdʒɑnsənz/
johnsey	/ˈdʒɑnzi/
johnson	/ˈdʒɑnsən/
johnson's	/ˈdʒɑnsənz/
johnsons	/ˈdʒɑnsənz/
johnston	/ˈdʒɑnstən/
johnston's	/ˈdʒɑnstənz/
johnstown	/ˈdʒɑnzˌtaʊn/
johnstown's	/ˈdʒɑnzˌtaʊnz/
johny	/ˈdʒɑni/
johson	/ˈdʒɑsən/
jollier	/ˈdʒɑɫiɝ/
jollies	/ˈdʒɑɫiz/
jolliest	/ˈdʒɑɫiəst/
jolly	/ˈdʒɑɫi/
jollying	/ˈdʒɑɫiɪŋ/
jon	/ˈdʒɑn/
jon's	/ˈdʒɑnz/
jonathan	/ˈdʒɑnəθən/
jonathan's	/ˈdʒɑnəθənz/
jonathon	/ˈdʒɑnəθən/
josh	/ˈdʒɑʃ/
joshua	/ˈdʒɑˌʃuə/
joshua's	/ˈdʒɑʃuəz/
jot	/ˈdʒɑt/
jotted	/ˈdʒɑtɪd/
