<!-- giovannoni	/dʒoʊvɑˈnoʊni/ -->
joanna	/dʒoʊˈænə/
<!-- johannes	/dʒoʊˈhænəs/ -->
jolene	/dʒoʊˈɫin/

joan	/ˈdʒoʊn/
jodi	/ˈdʒoʊdi/
jodie	/ˈdʒoʊdi/
jody	/ˈdʒoʊdi/
joe	/ˈdʒoʊ/
joe's	/ˈdʒoʊz/
joel	/ˈdʒoʊəɫ/
joel's	/ˈdʒoʊəɫz/
joes	/ˈdʒoʊz/
joey	/ˈdʒoʊi/
joey's	/ˈdʒoʊiz/
joke	/ˈdʒoʊk/
joked	/ˈdʒoʊkt/
joker	/ˈdʒoʊkɝ/
jokers	/ˈdʒoʊkɝz/
jokes	/ˈdʒoʊks/
jokester	/ˈdʒoʊkstɝ/
joking	/ˈdʒoʊkɪŋ/
jokingly	/ˈdʒoʊkɪŋɫi/
jolt	/ˈdʒoʊɫt/
jolted	/ˈdʒoʊɫtɪd/
jolting	/ˈdʒoʊɫtɪŋ/
jolts	/ˈdʒoʊɫts/
jonah	/ˈdʒoʊnə/
jonas	/ˈdʒoʊnəs/
jones	/ˈdʒoʊnz/
jones'	/ˈdʒoʊnz/
jones's	/ˈdʒoʊnzɪz/
jonesboro	/ˈdʒoʊnzbəɹoʊ/
joneses	/ˈdʒoʊnzɪz/
josef	/ˈdʒoʊsəf/
joseph	/ˈdʒoʊsəf/, /ˈdʒoʊzəf/
joseph's	/ˈdʒoʊzəfs/
josephine	/ˈdʒoʊsəˌfin/
josephine's	/ˈdʒoʊsəˌfinz/
josephs	/ˈdʒoʊsɪfs/, /ˈdʒoʊzɪfs/
josephson	/ˈdʒoʊsəfsən/
jovial	/ˈdʒoʊviəɫ/
jovian	/ˈdʒoʊviən/

joann	/ˌdʒoʊˈæn/
joanne	/ˌdʒoʊˈæn/
johannesburg	/ˌdʒoʊˈhænɪsbɝɡ/
johannesburg's	/ˌdʒoʊˈhænɪsbɝɡz/
johannesen	/ˌdʒoʊˈhænɪsən/
johannessen	/ˌdʒoʊˈhænɪsən/
johannsen	/ˌdʒoʊˈhænsən/
johansen	/ˌdʒoʊˈhænsən/
johanson	/ˌdʒoʊˈhænsən/
johansson	/ˌdʒoʊˈhɑnsən/, /ˌjoʊˈhɑnsən/
