choi	/ˈtʃɔɪ/
choice	/ˈtʃɔɪs/
choicer	/ˈtʃɔɪsɝ/
choicers	/ˈtʃɔɪsɝz/
choices	/ˈtʃɔɪsəz/, /ˈtʃɔɪsɪz/
choicest	/ˈtʃɔɪsəst/
chore	/ˈtʃɔɹ/
chores	/ˈtʃɔɹz/
chortle	/ˈtʃɔɹtəɫ/
chortled	/ˈtʃɔɹtəɫd/
chortles	/ˈtʃɔɹtəɫz/
chortling	/ˈtʃɔɹtəɫɪŋ/, /ˈtʃɔɹtɫɪŋ/
choy	/ˈtʃɔɪ/

cho	/ˈtʃoʊ/
choke	/ˈtʃoʊk/
choked	/ˈtʃoʊkt/
chokes	/ˈtʃoʊks/
choking	/ˈtʃoʊkɪŋ/
chose	/ˈtʃoʊz/
chosen	/ˈtʃoʊzən/
