pomelo

palmetto	/pæɫˈmɛtoʊ/, /pɑɫˈmɛtoʊ/
palmira	/pɑɫˈmɪɹə/
palmolive	/pɑɫˈmɑɫɪv/
partake	/pɑɹˈteɪk/
participant	/pɑɹˈtɪsəpənt/
participants	/pɑɹˈtɪsəpənts/
participants'	/pɑɹˈtɪsəpənts/
participate	/pɑɹˈtɪsəˌpeɪt/
participated	/pɑɹˈtɪsəˌpeɪtɪd/
participates	/pɑɹˈtɪsəˌpeɪts/
participating	/pɑɹˈtɪsəˌpeɪtɪŋ/
participation	/pɑɹˌtɪsəˈpeɪʃən/
participations	/pɑɹˌtɪsəˈpeɪʃənz/
partition	/pɑɹˈtɪʃən/
partitioned	/pɑɹˈtɪʃənd/
partitioning	/pɑɹˈtɪʃənɪŋ/
partitions	/pɑɹˈtɪʃənz/
<!-- pasquale	/pɑsˈkwɑɫeɪ/ -->
pontifical	/pɑnˈtɪfəkəɫ/
pontificate	/pɑnˈtɪfəˌkeɪt/
pontificated	/pɑnˈtɪfəˌkeɪtɪd/
pontificater	/pɑnˈtɪfəˌkeɪtɝ/
pontificaters	/pɑnˈtɪfəˌkeɪtɝz/
pontificates	/pɑnˈtɪfəˌkeɪts/
pontificating	/pɑnˈtɪfəˌkeɪtɪŋ/
pontification	/pɑnˌtɪfəˈkeɪʃən/
pontifications	/pɑnˌtɪfəˈkeɪʃənz/
pontoon	/pɑnˈtun/
<!-- posterity	/pɑˈstɛɹəti/ -->

pablo	/ˈpɑbɫoʊ/
<!-- pai	/ˈpɑi/ -->
palm	/ˈpɑɫm/, /ˈpɑm/
palm-springs	/ˈpɑɫmspɹɪŋz/, /ˈpɑmspɹɪŋz/
palma	/ˈpɑɫmə/
palma's	/ˈpɑɫməz/
palmdale	/ˈpɑmˌdeɪɫ/
palmdale's	/ˈpɑmˌdeɪɫz/
palmer	/ˈpɑɫmɝ/, /ˈpɑmɝ/
palmer's	/ˈpɑɫmɝz/, /ˈpɑmɝz/
palmist	/ˈpɑmɪst/
palmistry	/ˈpɑmɪstɹi/
palmists	/ˈpɑmɪsts/
palms	/ˈpɑɫmz/, /ˈpɑmz/
papa	/ˈpɑˌpə/
papa's	/ˈpɑˌpɑz/
papago	/ˈpɑpəˌɡoʊ/
papas	/ˈpɑpəz/
par	/ˈpɑɹ/
par's	/ˈpɑɹz/
parcel	/ˈpɑɹsəɫ/
parceled	/ˈpɑɹsəɫd/
parceling	/ˈpɑɹsəɫɪŋ/, /ˈpɑɹsɫɪŋ/
parcels	/ˈpɑɹsəɫz/
parch	/ˈpɑɹtʃ/
parched	/ˈpɑɹtʃt/
parchment	/ˈpɑɹtʃmənt/
pardon	/ˈpɑɹdən/
pardoned	/ˈpɑɹdənd/
pardoning	/ˈpɑɹdənɪŋ/
pardons	/ˈpɑɹdənz/
park	/ˈpɑɹk/
park's	/ˈpɑɹks/
parka	/ˈpɑɹkə/
parkas	/ˈpɑɹkəz/
parked	/ˈpɑɹkt/
parker	/ˈpɑɹkɝ/
parker's	/ˈpɑɹkɝz/
parkers	/ˈpɑɹkɝz/
parking	/ˈpɑɹkɪŋ/
parkinson	/ˈpɑɹkɪnsən/
parkinson's	/ˈpɑɹkɪnsənz/
parkinsonism	/ˈpɑɹkɪnsəˌnɪzɪm/
parkland	/ˈpɑɹˌkɫænd/
parkman	/ˈpɑɹkmən/
parks	/ˈpɑɹks/
parks'	/ˈpɑɹks/
parkside	/ˈpɑɹkˌsaɪd/
parkway	/ˈpɑɹˌkweɪ/
parlance	/ˈpɑɹɫəns/
parlay	/ˈpɑɹɫeɪ/
parlayed	/ˈpɑɹˌɫeɪd/
parlaying	/ˈpɑɹɫeɪɪŋ/
parlays	/ˈpɑɹɫeɪz/
parley	/ˈpɑɹɫi/
parliament	/ˈpɑɹɫəmənt/
parliament's	/ˈpɑɹɫəmənts/
parliaments	/ˈpɑɹɫəmənts/
parlor	/ˈpɑɹɫɝ/
parlors	/ˈpɑɹɫɝz/
parlour	/ˈpɑɹɫɝ/
parma	/ˈpɑɹmə/
parmentier	/ˈpɑɹməntiɝ/
parmesan	/ˈpɑɹməˌzɑn/
parnell	/ˈpɑɹnəɫ/
parr	/ˈpɑɹ/
pars	/ˈpɑɹz/
parse	/ˈpɑɹs/
parsec	/ˈpɑɹˌsɛk/
parsed	/ˈpɑɹst/
parser	/ˈpɑɹsɝ/
parsers	/ˈpɑɹsɝz/
parsi	/ˈpɑɹsi/
parsifal	/ˈpɑɹsɪfəɫ/, /ˈpɑɹzəˌfɑɫ/
parsimony	/ˈpɑɹsəˌmoʊni/
parsing	/ˈpɑɹsɪŋ/
parsley	/ˈpɑɹsɫi/
parson	/ˈpɑɹsən/
parsonage	/ˈpɑɹsənɪdʒ/
parsonages	/ˈpɑɹsənɪdʒəz/
parsons	/ˈpɑɹsənz/
part	/ˈpɑɹt/
part-time	/ˈpɑɹtˈtaɪm/
part's	/ˈpɑɹts/
parted	/ˈpɑɹtɪd/
parthenon	/ˈpɑɹθəˌnɑn/
parthian	/ˈpɑɹθiən/
partial	/ˈpɑɹʃəɫ/
partially	/ˈpɑɹʃəɫi/, /ˈpɑɹʃɫi/
participle	/ˈpɑɹtɪˌsɪpəɫ/
participles	/ˈpɑɹtɪˌsɪpəɫz/
particle	/ˈpɑɹtəkəɫ/, /ˈpɑɹtɪkəɫ/
particles	/ˈpɑɹtəkəɫz/, /ˈpɑɹtɪkəɫz/
partied	/ˈpɑɹtid/
parties	/ˈpɑɹtiz/
parties'	/ˈpɑɹˌtiz/, /ˈpɑɹtiz/
parting	/ˈpɑɹtɪŋ/
partisan	/ˈpɑɹtəzən/
partisans	/ˈpɑɹtəzənz/
partisanship	/ˈpɑɹtəzənˌʃɪp/
partly	/ˈpɑɹtɫi/
partner	/ˈpɑɹtnɝ/
partner's	/ˈpɑɹtnɝz/
partnered	/ˈpɑɹtnɝd/
partnering	/ˈpɑɹtnɝɪŋ/
partners	/ˈpɑɹtnɝz/
partners'	/ˈpɑɹtnɝz/
partnership	/ˈpɑɹtnɝˌʃɪp/
partnership's	/ˈpɑɹtnɝˌʃɪps/
partnerships	/ˈpɑɹtnɝˌʃɪps/
partnerships'	/ˈpɑɹtnɝʃɪps/
parton	/ˈpɑɹtən/
partridge	/ˈpɑɹtɹədʒ/, /ˈpɑɹtɹɪdʒ/
partridges	/ˈpɑɹtɹɪdʒɪz/
parts	/ˈpɑɹts/
parts'	/ˈpɑɹts/
party	/ˈpɑɹti/
party's	/ˈpɑɹtiz/
partying	/ˈpɑɹtiɪŋ/
pas	/ˈpɑz/
pas-de-deux	/ˈpɑdəˈdu/
pasha	/ˈpɑʃə/, /pəˈʃɑ/
pasta	/ˈpɑstə/
pastas	/ˈpɑstəz/
paz	/ˈpɑz/
pock	/ˈpɑk/
pocked	/ˈpɑkt/
pocket	/ˈpɑkət/
pocketbook	/ˈpɑkətˌbʊk/
pocketbooks	/ˈpɑkətˌbʊks/
pocketed	/ˈpɑkətɪd/
pocketful	/ˈpɑkətˌfʊɫ/
pocketing	/ˈpɑkətɪŋ/
pockets	/ˈpɑkəts/
pockmark	/ˈpɑkˌmɑɹk/
pockmarked	/ˈpɑkˌmɑɹkt/
pocks	/ˈpɑks/
pod	/ˈpɑd/
pod's	/ˈpɑdz/
podge	/ˈpɑdʒ/
pods	/ˈpɑdz/
pog	/ˈpɑɡ/
policies	/ˈpɑɫəsiz/
policy	/ˈpɑɫəsi/
policy's	/ˈpɑɫəsiz/
policyholder	/ˈpɑɫəsiˌhoʊɫdɝ/
policyholder's	/ˈpɑɫəsiˌhoʊɫdɝz/
policyholders	/ˈpɑɫəsiˌhoʊɫdɝz/
policyholders'	/ˈpɑɫəsiˌhoʊɫdɝz/
policymaker	/ˈpɑɫəsiˌmeɪkɝ/
policymakers	/ˈpɑɫəsiˌmeɪkɝz/
policymaking	/ˈpɑɫəsiˌmeɪkɪŋ/
<!-- polish	/ˈpɑɫɪʃ/, /ˈpoʊɫɪʃ/ -->
polished	/ˈpɑɫɪʃt/
polishing	/ˈpɑɫɪʃɪŋ/
politic	/ˈpɑɫəˌtɪk/
politicking	/ˈpɑɫəˌtɪkɪŋ/
politics	/ˈpɑɫəˌtɪks/
politics'	/ˈpɑɫəˌtɪks/
polity	/ˈpɑɫəti/
pollard	/ˈpɑɫɝd/
pollard's	/ˈpɑɫɝdz/
pollen	/ˈpɑɫən/
pollens	/ˈpɑɫənz/
pollinate	/ˈpɑɫəˌneɪt/
pollinated	/ˈpɑɫɪˌneɪtɪd/
pollinates	/ˈpɑɫəˌneɪts/
pollock	/ˈpɑɫək/
pollux	/ˈpɑɫəks/
poly	/ˈpɑɫi/
poly's	/ˈpɑɫiz/
polychrome	/ˈpɑˌɫiˌkɹoʊm/
polyesters	/ˈpɑˌɫiˌɛstɝz/
polygon	/ˈpɑɫɪˌɡɑn/
polygraph	/ˈpɑˌɫiˌɡɹæf/
polygraphs	/ˈpɑˌɫiˌɡɹæfs/
polymer	/ˈpɑɫəmɝ/
polymerase	/ˈpɑˌɫɪmɝˌeɪs/
polymerize	/ˈpɑɫɪmɝˌaɪz/
polymerized	/ˈpɑɫɪmɝˌaɪzd/
polymerizes	/ˈpɑɫɪmɝˌaɪzəz/
polymers	/ˈpɑɫɪmɝz/
polymorph	/ˈpɑˌɫiˌmɔɹf/
polyp	/ˈpɑɫɪp/
polyps	/ˈpɑɫɪps/
polytheism	/ˈpɑˌɫiθiɪzəm/
pommel	/ˈpɑməɫ/
pomp	/ˈpɑmp/
pompadour	/ˈpɑmpədɔɹ/
pompano	/ˈpɑmpəˌnoʊ/
pompoms	/ˈpɑmpɑmz/
ponce	/ˈpɑns/, /ˈpɑnseɪ/, /ˈpoʊnseɪ/
poncho	/ˈpɑntʃoʊ/
ponchos	/ˈpɑntʃoʊz/
pond	/ˈpɑnd/
pond's	/ˈpɑndz/
ponder	/ˈpɑndɝ/
pondered	/ˈpɑndɝd/
pondering	/ˈpɑndɝɪŋ/
ponderous	/ˈpɑndɝəs/
ponders	/ˈpɑndɝz/
ponds	/ˈpɑndz/
pontiac	/ˈpɑniˌæk/, /ˈpɑntiˌæk/
pontiac's	/ˈpɑniˌæks/, /ˈpɑntiˌæks/
pontiacs	/ˈpɑniˌæks/, /ˈpɑntiˌæks/
pop	/ˈpɑp/
pop's	/ˈpɑps/
popcorn	/ˈpɑpˌkɔɹn/
popeye	/ˈpɑˌpaɪ/
popeye's	/ˈpɑˌpaɪz/
poplar	/ˈpɑpɫɝ/
poplin	/ˈpɑpɫɪn/
poplins	/ˈpɑpɫɪnz/
popped	/ˈpɑpt/
popper	/ˈpɑpɝ/
poppers	/ˈpɑpɝz/
poppies	/ˈpɑpiz/
popping	/ˈpɑpɪŋ/
poppins	/ˈpɑpɪnz/
popple	/ˈpɑpəɫ/
poppy	/ˈpɑpi/
poppy's	/ˈpɑpiz/
poppycock	/ˈpɑpiˌkɔk/
pops	/ˈpɑps/
popsicle	/ˈpɑpsɪkəɫ/
populace	/ˈpɑpjəɫəs/
popular	/ˈpɑpjəɫɝ/
popularize	/ˈpɑpjəɫɝˌaɪz/
popularized	/ˈpɑpjəɫɝˌaɪzd/
popularizer	/ˈpɑpjəɫɝˌaɪzɝ/
popularizing	/ˈpɑpjəɫɝˌaɪzɪŋ/
popularly	/ˈpɑpjəɫɝɫi/
populate	/ˈpɑpjəˌɫeɪt/
populated	/ˈpɑpjəˌɫeɪtɪd/
populating	/ˈpɑpjəˌɫeɪtɪŋ/
populism	/ˈpɑpjəˌɫɪzəm/
populist	/ˈpɑpjəɫəst/
populists	/ˈpɑpjəɫɪs/, /ˈpɑpjəɫɪss/, /ˈpɑpjəɫɪsts/
populous	/ˈpɑpjəɫəs/
popup	/ˈpɑˌpəp/
posh	/ˈpɑʃ/
posit	/ˈpɑzət/
posited	/ˈpɑzətɪd/
positive	/ˈpɑzətɪv/
positively	/ˈpɑzətɪvɫi/
positives	/ˈpɑzətɪvz/
positivism	/ˈpɑzətɪˌvɪzəm/
positron	/ˈpɑzəˌtɹɑn/
positrons	/ˈpɑzəˌtɹɑnz/
posits	/ˈpɑzəts/
posse	/ˈpɑsi/
posses	/ˈpɑsiz/
possible	/ˈpɑsəbəɫ/
possibly	/ˈpɑsəbɫi/
possum	/ˈpɑsəm/
possums	/ˈpɑsəmz/
<!-- posthumous	/ˈpɑstʃʊməs/ -->
<!-- posthumously	/ˈpɑstʃʊməsɫi/ -->
postulate	/ˈpɑstʃəˌɫeɪt/, /ˈpɑstʃəɫət/
postulated	/ˈpɑstʃəˌɫeɪtɪd/
postulates	/ˈpɑstʃəˌɫeɪts/, /ˈpɑstʃəɫəts/
posture	/ˈpɑstʃɝ/
postures	/ˈpɑstʃɝz/
posturing	/ˈpɑstʃɝɪŋ/
posturings	/ˈpɑstʃɝɪŋz/
pot	/ˈpɑt/
pot's	/ˈpɑts/
potash	/ˈpɑˌtæʃ/
pothole	/ˈpɑtˌhoʊɫ/
potholed	/ˈpɑtˌhoʊɫd/
potholes	/ˈpɑtˌhoʊɫz/
potlatch	/ˈpɑtˌɫætʃ/
potluck	/ˈpɑtˌɫək/
potpie	/ˈpɑtˌpaɪ/
potpies	/ˈpɑtˌpaɪz/
pots	/ˈpɑts/
potsdam	/ˈpɑtsˌdæm/
potshot	/ˈpɑˌʃɑt/
potshots	/ˈpɑˌtʃɑts/
pottage	/ˈpɑtədʒ/
potted	/ˈpɑtɪd/
potter	/ˈpɑtɝ/
potter's	/ˈpɑtɝz/
potters	/ˈpɑtɝz/
pottery	/ˈpɑtɝi/
potty	/ˈpɑti/
poverty	/ˈpɑvɝti/
pox	/ˈpɑks/

paparazzi	/ˌpɑpɑˈɹɔˌzi/
paparazzi's	/ˌpɑpɑˈɹɔˌziz/
paparazzis	/ˌpɑpɑˈɹɔˌziz/
parfait	/ˌpɑɹˈfeɪ/
parfaits	/ˌpɑɹˈfeɪz/
parliamentarian	/ˌpɑɹɫəmənˈtɛɹiən/
parliamentarianism	/ˌpɑɹɫəmənˈtɛɹiənɪzəm/, /ˌpɑɹɫəmənˈtɛɹiənɪzm/
parliamentarians	/ˌpɑɹɫəmɛnˈtɛɹiənz/
parliamentary	/ˌpɑɹɫəˈmɛnɝi/, /ˌpɑɹɫəˈmɛntɝi/
parnassus	/ˌpɑɹˈnæsəs/
parsimonious	/ˌpɑɹsəˈmoʊniəs/
parthenogenetic	/ˌpɑɹθənoʊdʒəˈnɛtɪk/
partiality	/ˌpɑɹʃiˈæɫəti/
participative	/ˌpɑɹˈtɪsəpətɪv/
participatory	/ˌpɑɹˈtɪsəpəˌtɔɹi/
particular	/ˌpɑˈtɪkjəɫɝ/, /pɝˈtɪkjəɫɝ/
particularly	/ˌpɑɹˈtɪkjəɫɝɫi/, /pɝˈtɪkjəɫɝɫi/
particulates	/ˌpɑɹˈtɪkjəɫəts/
politician	/ˌpɑɫəˈtɪʃən/
politician's	/ˌpɑɫəˈtɪʃənz/
politicians	/ˌpɑɫəˈtɪʃənz/
politicians'	/ˌpɑɫəˈtɪʃənz/
pollination	/ˌpɑɫəˈneɪʃən/
pollyanna	/ˌpɑɫiˈænə/
polonaise	/ˌpɑɫəˈneɪz/
polyamide	/ˌpɑˌɫiˈæˌmaɪd/
polyandrous	/ˌpɑˌɫiˈændɹəs/
polyandry	/ˌpɑˌɫiˈændɹi/
polyester	/ˌpɑˌɫiˈɛstɝ/
polyethylene	/ˌpɑˌɫiˈɛθəˌɫin/
polyglot	/ˌpɑˌɫiɡɫɑt/
polyhedron	/ˌpɑˌɫiˈhidɹən/
polyhedrons	/ˌpɑˌɫiˈhidɹənz/
polymerization	/ˌpɑɫɪmɝəˈzeɪʃən/
polymorphic	/ˌpɑˌɫiˈmɔɹfɪk/
polymorphism	/ˌpɑˌɫiˈmɔɹfɪzm/
polynesia	/ˌpɑˌɫɪˈniʒə/
polynesian	/ˌpɑˌɫɪˈniʒən/
polynomial	/ˌpɑˌɫiˈnoʊmiəɫ/
polynomials	/ˌpɑˌɫiˈnoʊmiəɫz/
polyphonic	/ˌpɑˌɫɪˈfɑnɪk/
polypropylene	/ˌpɑˌɫiˈpɹoʊpəˌɫin/
polysaccharide	/ˌpɑˌɫiˈsækɝˌaɪd/
polysaccharides	/ˌpɑˌɫiˈsækɝˌaɪdz/
polystyrene	/ˌpɑˌɫiˈstaɪˌɹin/
polysyllabic	/ˌpɑˌɫisɪˈɫæbɪk/
polytechnic	/ˌpɑˌɫiˈtɛknɪk/, /ˌpɑɫɪˈtɛknɪk/
polytheistic	/ˌpɑˌɫiθiˈɪstɪk/
polyurethane	/ˌpɑˌɫiˈʊɹəˌθeɪn/
polyvinyl	/ˌpɑɫiˈvaɪnəɫ/
pomegranate	/ˌpɑməˈɡɹænət/
pomerania	/ˌpɑmɝˈeɪniə/
pomeranian	/ˌpɑmɝˈeɪniən/
pomodoro	/ˌpɑməˈdɔɹoʊ/
pomposity	/ˌpɑmˈpɑsɪti/
ponderosa	/ˌpɑndɝˈoʊsə/
ponderosa's	/ˌpɑndɝˈoʊsəz/
pontoons	/ˌpɑnˈtunz/
popularity	/ˌpɑpjəˈɫɛɹəti/
popularization	/ˌpɑpjəɫɝəˈzeɪʃən/
population	/ˌpɑpjəˈɫeɪʃən/
populations	/ˌpɑpjəˈɫeɪʃənz/
possibilities	/ˌpɑsəˈbɪɫətiz/
possibility	/ˌpɑsəˈbɪɫəˌti/
potboiler	/ˌpɑˈbɔɪɫɝ/
potboilers	/ˌpɑˈbɔɪɫɝz/
