fujitsu	/fuˈdʒɪtsu/
fujitsu's	/fuˈdʒɪtsuz/
fujiwara	/fudʒiˈwɑɹə/
fujiya	/fuˈdʒijə/
fukuda	/fuˈkudə/
fukui	/fuˈkui/
fukumoto	/fukuˈmoʊtoʊ/
fukunaga	/fukuˈnɑɡə/
fukushima	/fukuˈʃimə/

foo	/ˈfu/
foobar	/ˈfuˈbɑɹ/
food	/ˈfud/
food's	/ˈfudz/
foodie	/ˈfudi/
foodmaker	/ˈfudˌmeɪkɝ/
foodmaker's	/ˈfudˌmeɪkɝz/
foodmakers	/ˈfudˌmeɪkɝz/
foods	/ˈfudz/
foods'	/ˈfudz/
foodservice	/ˈfudˈsɝvɪs/
foodstuff	/ˈfudˌstəf/
foodstuffs	/ˈfudˌstəfs/
foodtown	/ˈfudˌtaʊn/
foodway	/ˈfudˌweɪ/
foodways	/ˈfudˌweɪz/
fool	/ˈfuɫ/
fool's	/ˈfuɫz/
fooled	/ˈfuɫd/
foolery	/ˈfuɫɝi/
foolhardy	/ˈfuɫˌhɑɹdi/
fooling	/ˈfuɫɪŋ/
foolish	/ˈfuɫɪʃ/
foolishly	/ˈfuɫɪʃɫi/
foolishness	/ˈfuɫɪʃnəs/
foolproof	/ˈfuɫˌpɹuf/
fools	/ˈfuɫz/
foosball	/ˈfusˌbɔɫ/
fuji	/ˈfudʒi/
fuji's	/ˈfudʒiz/
phooey	/ˈfui/
phu	/ˈfu/

foodarama	/ˌfudɝˈæmə/
fujian	/ˌfuˈdʒiən/
fujikawa	/ˌfudʒiˈkɑwə/
fujikura	/ˌfudʒɪˈkuɹə/
fujimori	/ˌfudʒiˈmɔɹi/
fujimori's	/ˌfudʒiˈmɔɹiz/
fujimoto	/ˌfudʒiˈmoʊtoʊ/
fujioka	/ˌfudʒiˈoʊkə/
fujisankei	/ˌfudʒɪˈsɑŋkeɪ/
fujisawa	/ˌfudʒɪˈsɑwə/
fujiyama	/ˌfudʒiˈjɑmə/
fukowoka	/ˌfukoʊˈwɔkə/
fukuoka	/ˌfuˌkuˈoʊkə/
fukuyama	/ˌfuˌkuˈjɑmə/
fulani	/ˌfuˈɫɑni/
