tabacalera	/təˌbækəˈɫɛɹə/
tabachneck	/təˈbɑtʃˌnɛk/
tabak	/ˈtæbæk/, /təˈbæk/
tabasco	/təˈbæskoʊ/
tableau	/təˈbɫoʊ/
tableaux	/təˈbɫoʊ/
tacoma	/təˈkoʊmɑ/
tacoma's	/təˈkoʊməz/
tafaro	/təˈfɑɹoʊ/
tafolla	/təˈfɑɫə/
taganka	/təˈɡɑŋkə/
tahiti	/təˈhiti/
takeshi	/təˈkɛʃi/
takihyo	/təˈkijoʊ/
takoma	/təˈkoʊmə/
takoma's	/təˈkoʊməz/
takomas	/təˈkoʊməz/
talal	/təˈɫɑɫ/
talese	/təˈɫiz/, /təˈɫizi/
tallil	/təˈɫɪɫ/
tamales	/təˈmɑɫiz/
tamara	/təˈmɑɹə/
tamil	/ˈtæmɪɫ/, /təˈmɪɫ/
tamils	/ˈtæmɪɫz/, /təˈmɪɫz/
taneja	/təˈneɪhə/
tapias	/təˈpiəs/
tarantula	/təˈɹæntʃəɫə/, /təˈɹæntʃuɫə/
tarantulas	/təˈɹæntʃəɫəz/, /təˈɹæntʃuɫəz/
tateho	/təˈteɪhoʊ/
tateho's	/təˈteɪhoʊz/
tatsukichi	/tətsuˈkiˌtʃi/
tbilisi	/təˈbɫisi/, /təbɪˈɫisi/
tebelskis	/təˈbɛɫskis/
tecumseh	/təˈkəmsə/
teixeira	/təˈʃɛɹə/
telemetry	/təˈɫɛmətɹi/
telepathy	/təˈɫɛpəθi/
telomerase	/təˈɫoʊmɝˌeɪz/
temecula	/təˈmɛkjəɫə/
temerity	/təˈmɛɹəti/
tenacious	/təˈneɪʃəs/
tenaciously	/təˈneɪʃəsɫi/
tenacity	/təˈnæsɪti/
tequila	/təˈkiɫə/
tequiliu	/təˈkiɫju/
tibet	/təˈbɛt/
tibetans	/təˈbɛtənz/
timidity	/təˈmɪdəti/
titania	/təˈtɑnjə/
to	/ˈtu/, /tə/, /tɪ/
tobacco	/təˈbæˌkoʊ/
tobacco's	/təˈbæˌkoʊz/
tobaccos	/təˈbæˌkoʊz/
tobago	/təˈbeɪɡoʊ/
tobias	/təˈbaɪəs/
tobiason	/təˈbaɪəsən/
toboggan	/təˈbɑɡən/
toboggans	/təˈbɑɡənz/
tobolski	/təˈboʊɫski/
today	/təˈdeɪ/, /tuˈdeɪ/
today'll	/təˈdeɪɫ/, /tuˈdeɪɫ/
today's	/ˈtudeɪz/, /təˈdeɪz/
todays	/ˈtudeɪz/, /təˈdeɪz/
together	/təˈɡɛðɝ/
togetherness	/təˈɡɛðɝnəs/
togethers	/təˈɡɛðɝz/
tokarski	/təˈkɑɹski/
toledo	/təˈɫidoʊ/
toledo's	/təˈɫidoʊz/
tomasek	/təˈmɑsɛk/
tomasic	/təˈmɑsɪk/
tomasik	/təˈmɑsɪk/
tomasko	/təˈmɑskoʊ/
tomaszewski	/təməˈʃɛfski/
tomato	/təˈmɑˌtoʊ/, /təˈmeɪˌtoʊ/
tomatoe	/təˈmɑtoʊ/, /təˈmeɪtoʊ/
tomatoes	/təˈmɑtoʊz/, /təˈmeɪtoʊz/
tomatos	/təˈmɑˌtoʊz/, /təˈmeɪˌtoʊz/
tomayko	/təˈmaɪkoʊ/
tomorrow	/təˈmɑˌɹoʊ/, /tuˈmɑˌɹoʊ/
tomorrow's	/təˈmɑˌɹoʊz/, /tuˈmɑˌɹoʊz/
tomorrows	/təˈmɑˌɹoʊz/, /tuˈmɑˌɹoʊz/
tondreau	/tənˈdɹoʊ/
tonight	/təˈnaɪt/, /tʊˈnaɪt/
tonight's	/təˈnaɪts/, /tʊˈnaɪts/
tonite	/təˈnaɪt/
topalian	/təˈpeɪɫiən/
topanga	/təˈpæŋɡə/, /toʊˈpæŋˌɡɑ/
topeka	/təˈpikɑ/, /toʊˈpikɑ/
topeka's	/təˈpikəz/
topekan	/təˈpikən/
topekans	/təˈpikənz/
topography	/təˈpɑɡɹəfi/
topological	/təpəˈɫɑdʒɪkəɫ/
topology	/təˈpɔɫədʒi/
topolski	/təˈpoʊɫski/
totino's	/təˈtinoʊz/
toward	/ˈtɔɹd/, /təˈwɔɹd/
towards	/ˈtɔɹdz/, /təˈwɔɹdz/
tuberculosis	/təˌbɝkjəˈɫoʊsɪs/, /tuˌbɝkjəˈɫoʊsəs/, /tuˌbɝkjuˈɫoʊsəs/
tucholski	/təˈhoʊɫski/
tuskegee	/ˈtəskəˌɡi/, /təˈskiˌɡi/
tussaud's	/təˈsoʊz/, /tuˈsoʊz/
tuxedos	/təkˈsiˌdoʊz/
tvsat	/təvˈsæt/
typography	/təˈpɑɡɹəfi/
